####################
#...............E..#
#...G..............#
#.........G........#
#..................#
#..................#
#...G..............#
#.............G....#
####################

