####################
#..............GE..#
#...G..............#
#..................#
#..................#
#...............G..#
#..................#
#..................#
####################