####################
#.........G........#
#.................#
#.........G........#
#.........E........#
#..................#
#..................#
#..G...............#
####################